DOR = "countries/Dorwinion.txt"
DGU = "countries/Dol Guldur.txt"
MMO = "countries/Minas Morgul.txt"
RHD = "countries/Rhudaur.txt"
SHI = "countries/Shire.txt"
ERE = "countries/Erebor.txt"
ENE = "countries/Enedwaith.txt"
LIN = "countries/Lindon.txt"
ENT	= "countries/Entwood.txt"
ITH = "countries/Ithilien.txt"
CAR = "countries/Cardolan.txt"
HLI = "countries/Harlindon.txt"
DAL = "countries/Dale.txt"
RIV = "countries/Rivendell.txt"
ANG = "countries/Angmar.txt"
SPI = "countries/Spiders.txt"
ART = "countries/Arthedain.txt"
VAL = "countries/Anduin.txt"
MOA = "countries/Moria.txt"
MOC = "countries/OrcMoria.txt"
DAG	= "countries/Dagorlad.txt"
KND = "countries/Khand.txt"
ISE = "countries/Isengard.txt"
ROH = "countries/Rohan.txt"
UMB = "countries/Umbar.txt"
RHU = "countries/Rhun.txt"
LTH	= "countries/Lothlorien.txt"
PEL	= "countries/Pellardur.txt"
MIR = "countries/Mirkwood.txt"
NEP = "countries/Forodwaith.txt"
MOR = "countries/Mordor.txt"
HAR = "countries/Harad.txt"
GON = "countries/Gondor.txt"
GUN = "countries/Gundabad.txt"


# TA Additions

ANA = "countries/Annabrith.txt"
CAS = "countries/Castamir.txt"
CHE = "countries/Chelkar.txt"
HRD = "countries/Harad Tribes.txt"
HRZ = "countries/Haruzan.txt"
KHA = "countries/Khand.txt"
MET = "countries/Methir.txt"
WAS = "countries/Wasteland.txt"
ANF = "countries/Anfalas.txt"

PIN = "countries/Pinnath Gelin.txt"
LAM = "countries/Lamedon.txt"
LEB = "countries/Lebennin.txt"
BEL = "countries/Belfalas.txt"
DEE = "countries/Dor en Ernil.txt"
LOS = "countries/Lossarnach.txt"
BLA = "countries/Blackroot Vale.txt"

LIT = "countries/Litash.txt"
MRK = "countries/Morkai.txt"
FOR = "countries/Forochel.txt"
URU = "countries/Uroth-Burm.txt"
CRC = "countries/Caras Celairnen.txt"
ANU = "countries/Annuminas.txt"
FRN = "countries/Fornost.txt"
ASH = "countries/Askhai.txt"
ETN = "countries/Ettenmoors.txt"
DUN = "countries/Dunedain Rangers.txt"
SIR = "countries/Sirgale.txt"
CRN = "countries/Cardolanian Northmen.txt"
BRE = "countries/Bree.txt"
RED = "countries/Red Hillmen.txt"
FAR = "countries/Faerdor.txt"
ERG = "countries/Eregion.txt"
GIR = "countries/Girithlin.txt"
ARD = "countries/Ar-Dagor.txt"
ERY = "countries/Eryn Vorn.txt"
DRU = "countries/Druwaith Laur.txt"
FAL = "countries/Faulgurum.txt"
LND = "countries/Lindon.txt"
FRL = "countries/Forlindon.txt"
HRL = "countries/Harlindon.txt"
KZA = "countries/Khazad Kazar.txt"
GRE = "countries/Great Eagles.txt"
BUZ = "countries/Buzdum Mazar.txt"
LTN = "countries/Lothlann.txt"
ERD = "countries/Ered Gorgoroth.txt"
TOK = "countries/Tookland.txt"
SHR = "countries/Shire.txt"
ANR = "countries/Carn Dum.txt"
RDU = "countries/Rhudaur.txt"
GND = "countries/Gundabad.txt"
CRL = "countries/Cairill.txt"
CAI = "countries/Caithinn.txt"
COR = "countries/Corddwallon.txt"
ARI = "countries/Ariantig.txt"
EUC = "countries/Eucbenn.txt"
TRE = "countries/Trebhearn.txt"
EST = "countries/Estanrewas.txt"
BEO = "countries/Beornings of the Anduin Vale.txt"
WOD = "countries/Woodmen.txt"
BGR = "countries/Beornings of the Grey Foothills.txt"
DLG = "countries/Dol Gudur.txt"
SHA = "countries/Shadow of Mirkwood.txt"
SAG = "countries/Sagath.txt"
ASD = "countries/Asdriags.txt"
URG = "countries/Urgath.txt"
LOG = "countries/Logath.txt"
EMY = "countries/Emyn-nu-Fuin.txt"
LOR = "countries/Lor-Uruk-Shab.txt"
DRW = "countries/Dorwinion.txt"
DUR = "countries/Durins Folk.txt"
DLE = "countries/Dale.txt"
IRN = "countries/Emyn Engrin.txt"
AST = "countries/Austrabuht.txt"
WDR = "countries/Woodland Realm.txt"
TAU = "countries/Taurdirim.txt"
IML = "countries/Imladris.txt"
KDU = "countries/Khazad-Dum.txt"
CRS = "countries/Lothlorien.txt"
FAN = "countries/Fangorn.txt"
LEO = "countries/Leofringas.txt"
ISN = "countries/Isengard.txt"
RID = "countries/Riddermark.txt"
EAS = "countries/Eastmark.txt"
WES = "countries/Westmarch.txt"
WST = "countries/Westfold.txt"
AND = "countries/Andrast.txt"
ITL = "countries/Ithilien.txt"
MRD = "countries/Mordor.txt"
MRG = "countries/Minas Morgul.txt"
LAU = "countries/Laur Clansmoot"
STE = "countries/Stewardship"
NUR = "countries/Nurn.txt"
ERN = "countries/Ered Eryn.txt"
HAS = "countries/Has Anunen.txt"
UMA = "countries/Umbar.txt"
DRA = "countries/Dragon Kingdom.txt"
DRG = "countries/Draigh-Luth"
MUR = "countries/Mournshaws"